000001111111111111111111111112211111111111111111111111100000
000001000000000000000000000002200000000000000000000000100000
000001000000000000000000000002200000000000000000000000100000
000001000000000000000000000002200000000000000000000000100000
000001000000000000000000000002200000000000000000000000100000
000001111111111111111111111112211111111111111111111111100000
000001000000000000000000000002200000000000000000000000100000
000001000000000000000000000002200000000000000000000000100000
000001000000000000000000000002200000000000000000000000100000
000001000000000000000000000002200000000000000000000000100000
000001111111111111111111111112211111111111111111111111100000
000001000000000000000000000002200000000000000000000000100000
000001000000000000000000000002200000000000000000000000100000
000001000000000000000000000002200000000000000000000000100000
000001000000000000000000000002200000000000000000000000100000
000001111111111111111111111112211111111111111111111111100000
000001000000000000000000000002200000000000000000000000100000
000001000000000000000000000002200000000000000000000000100000
000001000000000000000000000002200000000000000000000000100000
000001000000000000000000000002200000000000000000000000100000
000001111111111111111111111112211111111111111111111111100000
000001000000000000000000000002200000000000000000000000100000
000001000000000000000000000002200000000000000000000000100000
000001000000000000000000000002200000000000000000000000100000
000001000000000000000000000002200000000000000000000000100000
000001111111111111111111111112211111111111111111111111100000
000000000000000000000000000002200000000000000000000000000000
000000000000000000000000000002200000000000000000000000000000
000000000000000000000000000002200000000000000000000000000000
111111111111111111111111111111111111111111111111111111111111
